||||||||||||||||||||||||||||||||||||||||||||||||||
|                                                |
|                                                |
|                                                |
|             *                  *               |
|             *                  *               |
|             *                  *               |
|####         *                  *           ####|
|####         *          DDD     *           ####|
|####         *                  *           ####|
|####         *                  *           ####|
|             *    DDD           *               |
|             *                  *               |
|                                                |
|                          DDD                   |
|                                                |
|                                                |
|                                                |
|||||||||||||||||||==========|||||||||||||||||||||
